41
16
1 1 4 0 0 0 0 0 0 0 0 0 0 0 0 0 0 0 0 0 0 0 0 0 0 0 0 0 0 0 0 0 0 0 0 0 0 0 0 0 0 0 0 0 3 0 1 1 4 0 0 0 0 0 0 0 0 0 0 0 0 0 0 0 0 0 0 0 0 0 0 0 0 0 0 0 0 0 3 0 1 1 
1 1 4 0 0 0 0 0 0 0 0 0 0 0 0 0 0 0 0 0 0 0 0 0 0 0 0 0 0 0 0 0 0 0 0 0 0 0 0 0 0 0 0 0 3 0 1 1 4 0 0 0 0 0 0 0 0 0 0 0 0 0 0 0 0 0 0 0 0 0 0 0 0 0 0 0 0 0 3 0 1 1 
1 1 4 0 0 0 0 0 0 0 0 0 0 0 0 0 0 0 0 0 0 0 0 0 0 0 0 0 0 0 0 0 0 0 0 0 0 0 0 0 0 0 0 0 3 0 1 1 4 0 0 0 0 0 0 0 0 0 0 0 0 0 0 0 0 0 0 0 0 0 0 0 0 0 0 0 0 0 3 0 1 1 
1 1 4 0 0 0 0 0 0 0 0 0 0 0 0 0 0 0 0 0 0 0 0 0 0 0 0 0 0 0 0 0 0 0 0 0 0 0 9 0 0 0 0 0 3 0 1 1 4 0 0 0 0 0 0 0 0 0 0 0 0 0 0 0 0 0 0 0 0 0 0 0 0 0 0 0 0 0 3 0 1 1 
1 1 4 0 0 0 0 0 0 0 0 0 0 0 0 0 1 0 0 1 1 2 1 2 1 2 1 2 1 2 1 2 1 2 0 1 0 1 0 1 0 1 0 1 2 0 1 1 4 0 0 0 0 0 1 0 0 1 2 0 0 0 0 0 0 0 0 0 0 0 0 0 1 0 0 1 0 1 0 1 6 1 
1 1 4 0 0 0 2 1 3 1 4 1 10 0 0 0 3 0 1 1 0 2 0 2 0 2 0 2 0 2 0 2 0 2 1 1 19 0 17 0 17 0 17 0 0 0 1 1 4 0 0 0 1 0 0 1 6 1 4 0 0 0 0 0 0 0 0 0 0 0 0 0 3 0 1 1 1 1 1 1 1 1 
1 1 4 0 0 0 0 0 0 0 1 0 0 1 2 0 3 0 1 1 0 2 0 2 0 2 0 2 0 2 0 2 0 2 1 1 4 0 0 0 1 1 1 1 1 1 1 1 4 0 1 0 0 1 6 1 1 1 4 0 0 0 0 0 0 0 0 0 0 0 0 0 3 0 1 1 1 1 1 1 1 1 
1 1 4 0 0 0 0 0 0 0 3 0 1 1 4 0 3 0 1 1 0 2 0 2 0 2 0 2 0 2 0 2 0 2 1 1 4 0 0 0 17 0 17 0 18 0 1 1 1 0 0 1 6 1 1 1 1 1 1 1 1 1 1 1 1 1 1 1 1 1 1 1 1 1 1 1 1 1 1 1 1 1 
1 1 4 0 0 0 0 0 0 0 0 0 17 0 1 0 0 1 6 1 0 2 0 2 0 2 0 2 0 2 0 2 0 2 1 1 4 0 0 0 0 0 0 0 3 0 1 1 0 0 17 0 17 0 17 0 17 0 17 0 17 0 17 0 17 0 17 0 17 0 17 0 17 0 17 0 18 0 1 1 1 1 
1 1 4 0 0 0 0 0 0 0 0 0 9 0 3 0 1 1 1 1 0 2 0 2 0 2 0 2 0 2 0 2 0 2 1 1 1 1 1 1 0 0 1 1 3 0 1 1 1 1 1 1 1 1 1 1 1 1 1 1 1 1 1 1 1 1 1 1 1 1 1 1 1 1 0 0 1 1 1 1 1 1 
5 1 0 1 0 1 0 1 0 1 0 1 0 1 0 1 6 1 1 1 0 2 0 2 0 2 0 2 0 2 0 2 0 2 1 1 19 0 17 0 0 0 17 0 3 0 1 1 1 1 19 0 17 0 17 0 17 0 17 0 17 0 17 0 17 0 17 0 17 0 17 0 17 0 0 0 18 0 1 1 1 1 
1 1 1 1 1 1 1 1 1 1 1 1 1 1 1 1 1 1 1 1 0 2 0 2 0 2 0 2 0 2 0 2 0 2 1 1 4 0 0 0 1 1 1 1 1 1 0 0 17 0 0 0 0 0 0 0 0 0 0 0 0 0 0 0 0 0 0 0 0 0 0 0 0 0 0 0 3 0 1 1 1 1 
1 1 1 1 1 1 1 1 1 1 1 1 1 1 1 1 1 1 0 2 0 2 0 2 0 2 0 2 0 2 0 2 0 2 1 1 0 0 0 0 17 0 17 0 17 0 0 0 0 0 0 0 0 0 0 0 0 0 0 0 0 0 0 0 0 0 0 0 0 0 0 0 1 1 1 1 1 1 1 1 1 1 
0 2 0 2 0 2 0 2 0 2 0 2 0 2 0 2 0 2 0 2 0 2 0 2 0 2 0 2 0 2 0 2 0 2 1 1 1 1 1 1 1 1 1 1 1 1 1 1 1 1 1 1 1 1 0 0 1 1 0 0 1 1 0 0 1 1 0 0 1 1 0 0 1 1 1 1 1 1 1 1 1 1 
0 2 0 2 0 2 0 2 0 2 0 2 0 2 0 2 0 2 0 2 0 2 0 2 0 2 0 2 0 2 0 2 0 2 1 1 1 1 1 1 1 1 1 1 1 1 1 1 1 1 1 1 1 1 0 0 1 1 0 0 1 1 0 0 1 1 0 0 1 1 0 0 1 1 1 1 1 1 1 1 1 1 
0 2 0 2 0 2 0 2 0 2 0 2 0 2 0 2 0 2 0 2 0 2 0 2 0 2 0 2 0 2 0 2 0 2 1 1 1 1 1 1 1 1 1 1 1 1 1 1 1 1 1 1 1 1 0 0 1 1 0 0 1 1 0 0 1 1 0 0 1 1 0 0 1 1 1 1 1 1 1 1 1 1 
